######
#A#B #
# #  #
#    #
######
